4 4 4 4 4 4 4 4 4 4 4 4 4 4 4 4 4 4 4 4 4 4 4 4 4 4 4 4 4 4 4 4
4 1 4 4 4 1 1 1 1 4 1 1 1 4 4 4 4 4 1 4 4 4 4 4 4 4 1 4 4 4 4 4
4 4 1 4 1 1 4 1 1 1 1 4 4 1 1 1 4 4 4 4 1 1 1 4 1 1 1 1 1 1 1 4
4 4 4 4 4 4 4 1 1 4 1 1 4 1 4 1 1 1 1 1 1 4 1 1 1 4 1 4 4 1 1 4
4 1 4 4 1 1 4 1 4 4 4 4 4 1 4 4 1 4 1 4 1 1 1 4 1 4 1 4 1 4 1 4
4 1 4 4 1 4 4 1 4 4 1 4 4 1 1 4 4 1 1 4 1 1 4 4 1 1 1 1 1 4 4 4
4 1 1 1 1 1 4 1 4 1 1 1 4 1 4 1 4 4 1 4 1 1 1 1 4 1 4 4 1 1 1 4
4 4 4 1 4 1 1 6 1 1 1 1 1 1 1 4 4 4 1 4 1 4 4 4 4 1 4 1 1 4 1 4
4 1 1 1 4 1 4 1 1 4 4 1 1 4 1 4 1 1 1 4 4 1 1 1 1 4 1 1 4 4 4 4
4 1 4 4 4 4 4 4 4 4 4 1 4 1 1 1 4 4 4 4 4 1 1 1 1 4 1 1 1 1 1 4
4 1 4 1 4 4 1 4 1 4 1 1 4 1 1 4 4 4 4 1 4 1 1 1 4 4 4 1 1 4 1 4
4 1 4 1 4 1 1 1 1 4 4 1 4 4 1 4 4 1 1 4 4 4 4 4 1 1 1 1 1 1 1 4
4 1 4 1 1 1 1 1 1 4 1 1 4 4 4 4 4 1 1 1 4 4 1 4 4 1 4 4 4 1 1 4
4 1 4 4 4 4 4 4 4 1 1 1 4 1 1 1 4 4 4 4 1 1 1 1 1 1 4 1 1 1 1 4
4 1 1 1 4 1 4 1 4 1 4 4 4 1 4 1 1 1 1 4 4 4 4 4 4 4 4 4 4 4 4 4
4 1 4 1 1 1 1 1 4 1 4 1 1 1 4 1 1 4 1 1 4 1 4 1 1 1 4 1 4 4 1 4
4 1 4 4 4 4 4 4 4 4 4 1 4 4 4 4 4 4 4 1 4 1 4 1 4 1 4 1 1 4 1 4
4 1 1 1 1 4 1 1 1 1 4 1 4 1 1 1 1 1 1 1 4 1 4 1 4 1 4 4 1 4 1 4
4 1 4 4 1 4 1 1 4 1 4 1 4 1 4 4 4 4 4 4 4 1 1 1 4 1 4 1 1 4 1 4
4 1 1 4 1 4 1 4 4 4 4 4 4 1 4 1 1 4 1 4 1 1 4 1 4 1 4 1 4 4 1 4
4 1 4 4 1 4 1 4 1 1 1 1 4 1 1 1 4 4 1 1 4 1 4 1 4 1 1 1 1 4 1 4
4 1 4 1 1 4 1 4 1 4 1 1 4 1 4 1 1 4 1 4 4 4 4 4 4 4 4 4 4 4 1 4
4 1 4 1 4 4 1 4 1 4 1 1 4 1 4 1 4 4 1 1 1 1 4 1 1 1 1 1 1 1 1 4
4 1 4 1 1 1 1 4 4 4 1 4 4 1 4 1 1 4 4 4 4 4 4 4 4 4 4 4 4 4 4 4
4 1 4 1 4 4 4 4 4 1 1 1 4 1 4 4 1 1 1 1 1 1 1 1 1 1 1 1 1 1 1 4
4 4 4 1 4 1 1 1 4 1 4 4 4 1 4 1 1 4 4 4 4 4 4 1 4 4 4 4 4 4 1 4
4 1 1 1 4 1 4 1 1 1 1 1 1 1 4 1 1 1 1 1 1 1 4 1 4 1 1 1 1 4 1 4
4 1 4 1 4 1 4 4 4 4 4 4 4 1 4 1 4 4 1 4 4 1 4 1 4 1 4 4 1 4 1 4
4 1 4 1 1 1 1 1 1 1 1 1 4 1 4 1 1 4 1 1 1 1 4 1 4 1 4 1 1 4 1 4
4 1 4 4 4 1 4 4 4 4 4 1 4 1 4 4 4 4 4 4 4 4 4 1 4 1 4 4 4 4 1 4
4 1 1 1 4 1 1 1 1 4 1 1 4 1 1 1 1 1 1 1 1 1 1 1 1 1 1 1 1 4 7 4
4 4 4 4 4 4 4 4 4 4 4 4 4 4 4 4 4 4 4 4 4 4 4 4 4 4 4 4 4 4 4 4

