4 4 4 4 4 4 4 4 4 4 4 4 4 4 4 4
4 1 1 4 4 4 1 1 1 1 1 1 1 1 1 4
4 4 1 4 1 4 1 4 4 4 4 4 4 4 1 4
4 4 1 4 1 1 1 1 1 1 1 1 1 4 1 4
4 1 1 4 1 4 4 4 4 4 1 4 1 4 1 4
4 1 4 4 1 4 1 1 1 4 1 4 1 4 1 4
4 1 1 1 1 4 1 1 1 4 1 4 1 4 1 4
4 4 4 4 1 4 1 6 1 4 1 4 1 4 1 4
4 1 1 1 1 1 1 1 1 1 1 4 1 1 1 4
4 1 4 4 4 4 4 4 4 4 1 4 4 4 1 4
4 1 4 1 1 1 1 1 1 1 1 1 1 4 1 4
4 1 4 1 4 4 4 4 4 4 4 4 1 4 1 4
4 1 4 1 4 1 1 1 1 1 1 1 1 4 1 4
4 1 4 1 4 4 4 4 4 4 4 4 4 4 1 4
4 1 1 1 4 1 1 1 1 1 1 1 1 7 1 4
4 4 4 4 4 4 4 4 4 4 4 4 4 4 4 4

